#Version
1.8.0.3

#Music Category
5

#Width
25

#Height
15

#Sprite Water Layer
0,0,0,0,0,0,0,0,0,0,0,0,0,0,0,0,0,0,0,0,0,0,0,0,0
0,0,0,0,0,0,0,0,0,0,0,0,0,0,0,0,0,0,0,0,0,0,0,0,0
0,0,0,0,0,0,0,0,0,0,0,0,0,0,0,0,0,0,0,0,0,0,0,0,0
0,0,0,0,0,0,0,0,0,0,0,0,0,0,0,0,0,0,0,0,0,0,0,0,0
0,0,0,0,0,0,0,0,0,0,0,0,0,0,0,0,0,0,0,0,0,0,0,0,0
0,0,0,0,0,0,0,0,0,0,0,0,0,0,0,0,0,0,0,0,0,0,0,0,0
0,0,0,0,0,0,0,0,0,0,0,0,0,0,0,0,0,0,0,0,0,0,0,0,0
0,0,0,0,0,0,0,0,0,0,0,0,0,0,0,0,0,0,0,0,0,0,0,0,0
0,0,0,0,0,0,0,0,0,0,0,0,0,0,0,0,0,0,0,0,0,0,0,0,0
0,0,0,0,0,0,0,0,0,0,0,0,0,0,0,0,0,0,0,0,0,0,0,0,0
0,0,0,0,0,0,0,0,0,0,0,0,0,0,0,0,0,0,0,0,0,0,0,0,0
0,0,0,0,0,0,0,0,0,0,0,0,0,0,0,0,0,0,0,0,0,0,0,0,0
0,0,0,0,0,0,0,0,0,0,0,0,0,0,0,0,0,0,0,0,0,0,0,0,0
0,0,0,0,0,0,0,0,0,0,0,0,0,0,0,0,0,0,0,0,0,0,0,0,0
0,0,0,0,0,0,0,0,0,0,0,0,0,0,0,0,0,0,0,0,0,0,0,0,0

#Sprite Background Layer
241,241,241,241,241,241,241,241,241,241,241,241,241,241,241,241,241,254,0,0,0,0,0,255,241
241,241,241,241,241,241,241,241,241,241,241,241,241,241,241,241,241,254,0,0,0,0,245,265,241
241,241,241,241,241,241,241,241,241,241,241,241,241,241,241,241,267,243,0,0,0,0,255,241,241
241,241,241,241,241,241,241,241,241,241,241,241,241,241,241,241,254,0,0,0,0,245,265,241,241
241,241,241,241,241,241,241,241,241,241,241,241,241,241,241,267,243,245,253,244,0,255,241,241,241
241,241,241,241,241,241,241,241,241,241,241,241,241,241,241,254,245,265,241,266,244,255,241,241,241
241,241,241,241,241,241,241,241,241,241,241,241,241,241,241,254,255,241,241,241,254,255,241,241,241
264,241,241,241,241,241,241,241,241,241,241,241,241,241,241,266,250,264,241,267,251,265,241,241,267
242,252,264,241,241,241,241,241,241,241,241,241,241,241,241,241,266,250,252,251,265,241,241,241,254
0,0,242,252,252,264,241,241,241,241,267,252,252,264,241,241,241,266,253,265,241,241,241,267,243
0,0,0,0,0,242,252,252,252,252,243,0,0,242,252,264,241,241,241,241,241,267,252,243,0
0,0,0,0,0,0,0,0,0,0,0,0,0,0,0,242,252,252,252,252,252,243,0,0,0
0,0,0,0,0,0,0,0,0,0,0,0,0,0,5,13,13,13,13,13,13,13,4,0,0
0,0,0,0,0,0,0,0,0,0,5,13,13,13,25,1,1,1,1,1,1,1,26,13,13
0,0,0,0,0,0,0,0,0,0,15,1,1,1,1,1,1,1,1,1,1,1,1,1,1

#Sprite Foreground Layer
787,811,799,0,799,0,799,799,799,0,911,787,787,911,787,0,787,0,789,0,0,0,0,0,906
811,799,0,811,0,126,121,121,301,121,123,787,911,0,903,0,0,0,0,789,0,789,0,0,0
787,787,0,911,0,122,787,0,811,787,122,911,787,858,0,0,0,0,130,137,305,137,135,121,306
787,609,121,121,121,300,0,911,0,911,122,787,0,122,0,903,0,789,138,0,0,0,0,0,122
787,787,0,811,0,122,787,811,126,121,303,911,790,122,0,0,0,0,136,0,789,0,911,906,122
911,911,787,0,811,122,0,911,122,811,122,911,0,122,0,0,0,0,122,0,0,0,749,0,122
911,911,911,787,787,122,811,787,122,787,124,121,121,704,121,774,774,121,304,911,790,0,761,121,307
0,911,911,911,911,124,121,121,302,787,0,0,0,0,903,0,0,0,122,0,0,0,0,911,0
0,0,0,911,911,911,911,787,787,0,0,903,0,0,0,0,0,0,777,0,0,0,906,0,0
0,0,0,0,0,0,911,911,911,787,0,0,0,0,911,0,903,0,777,0,906,0,0,0,0
0,0,0,790,0,0,0,0,0,0,0,0,0,0,0,0,0,903,122,903,0,0,0,0,0
0,0,0,0,0,0,790,0,0,0,0,790,0,0,0,0,0,0,777,0,0,0,0,0,0
790,0,0,0,0,0,0,0,0,0,0,0,0,0,0,0,0,0,777,0,0,0,0,790,0
0,0,0,790,0,0,0,0,790,0,0,0,0,0,0,909,904,0,82,0,904,909,0,0,0
0,0,0,0,0,0,0,0,0,0,0,909,907,904,909,907,0,907,856,907,0,907,909,904,907

#Connections
0,0,0,0,0,0,0,0,0,0,0,0,0,0,0,0,0,0,0,0,0,0,0,0,0
0,0,0,0,0,5,2,2,2,2,6,0,0,0,0,0,0,0,0,0,0,0,0,0,0
0,0,0,0,0,1,0,0,0,0,1,0,0,1,0,0,0,0,5,2,2,2,2,2,6
0,2,2,2,2,7,0,0,0,0,1,0,0,1,0,0,0,0,1,0,0,0,0,0,1
0,0,0,0,0,1,0,0,5,2,7,0,0,1,0,0,0,0,1,0,0,0,0,0,1
0,0,0,0,0,1,0,0,1,0,1,0,0,1,0,0,0,0,1,0,0,0,0,0,1
0,0,0,0,0,1,0,0,1,0,4,2,2,8,2,2,2,2,7,0,0,0,2,2,3
0,0,0,0,0,4,2,2,3,0,0,0,0,0,0,0,0,0,1,0,0,0,0,0,0
0,0,0,0,0,0,0,0,0,0,0,0,0,0,0,0,0,0,1,0,0,0,0,0,0
0,0,0,0,0,0,0,0,0,0,0,0,0,0,0,0,0,0,1,0,0,0,0,0,0
0,0,0,0,0,0,0,0,0,0,0,0,0,0,0,0,0,0,1,0,0,0,0,0,0
0,0,0,0,0,0,0,0,0,0,0,0,0,0,0,0,0,0,1,0,0,0,0,0,0
0,0,0,0,0,0,0,0,0,0,0,0,0,0,0,0,0,0,1,0,0,0,0,0,0
0,0,0,0,0,0,0,0,0,0,0,0,0,0,0,0,0,0,1,0,0,0,0,0,0
0,0,0,0,0,0,0,0,0,0,0,0,0,0,0,0,0,0,1,0,0,0,0,0,0

#Tile Types (Stages, Doors, Start Tiles)
0,0,0,0,0,0,0,0,0,0,0,0,0,0,0,0,0,0,0,0,0,0,0,0,0
0,0,0,0,0,0,0,0,7,0,0,0,0,0,0,0,0,0,0,0,0,0,0,0,0
0,0,0,0,0,0,0,0,0,0,0,0,0,17,0,0,0,0,0,0,12,0,0,0,13
0,1,0,0,0,6,0,0,0,0,0,0,0,0,0,0,0,0,0,0,0,0,0,0,0
0,0,0,0,0,0,0,0,0,0,9,0,0,0,0,0,0,0,0,0,0,0,0,0,0
0,0,0,0,0,0,0,0,0,0,0,0,0,0,0,0,0,0,0,0,0,0,0,0,0
0,0,0,0,0,0,0,0,0,0,0,0,0,10,0,0,0,0,11,0,0,0,15,0,14
0,0,0,0,0,0,0,0,8,0,0,0,0,0,0,0,0,0,0,0,0,0,0,0,0
0,0,0,0,0,0,0,0,0,0,0,0,0,0,0,0,0,0,0,0,0,0,0,0,0
0,0,0,0,0,0,0,0,0,0,0,0,0,0,0,0,0,0,0,0,0,0,0,0,0
0,0,0,0,0,0,0,0,0,0,0,0,0,0,0,0,0,0,0,0,0,0,0,0,0
0,0,0,0,0,0,0,0,0,0,0,0,0,0,0,0,0,0,0,0,0,0,0,0,0
0,0,0,0,0,0,0,0,0,0,0,0,0,0,0,0,0,0,0,0,0,0,0,0,0
0,0,0,0,0,0,0,0,0,0,0,0,0,0,0,0,0,0,0,0,0,0,0,0,0
0,0,0,0,0,0,0,0,0,0,0,0,0,0,0,0,0,0,16,0,0,0,0,0,0

#Vehicle Boundaries
0,0,0,0,0,0,0,0,0,0,0,0,0,0,0,0,0,0,0,0,0,0,0,0,0
0,0,0,0,0,0,0,0,0,0,0,0,0,0,0,0,0,0,0,0,0,0,0,0,0
0,0,0,0,0,0,0,0,0,0,0,0,0,0,0,0,0,0,0,0,0,0,0,0,0
0,0,0,0,0,0,0,0,0,0,0,0,0,0,0,0,0,0,0,0,0,0,0,0,0
0,0,0,0,0,0,0,0,0,0,0,0,0,0,0,0,0,0,0,0,0,0,0,0,0
0,0,0,0,0,0,0,0,0,0,0,0,0,0,0,0,0,0,0,0,0,0,0,0,0
0,0,0,0,0,0,0,0,0,0,0,0,0,0,0,0,0,0,0,0,0,0,0,0,0
0,0,0,0,0,0,0,0,0,0,0,0,0,0,0,0,0,0,0,0,0,0,0,0,0
0,0,0,0,0,0,0,0,0,0,0,0,0,0,0,0,0,0,0,0,0,0,0,0,0
0,0,0,0,0,0,0,0,0,0,0,0,0,0,0,0,0,0,0,0,0,0,0,0,0
0,0,0,0,0,0,0,0,0,0,0,0,0,0,0,0,0,0,0,0,0,0,0,0,0
0,0,0,0,0,0,0,0,0,0,0,0,0,0,0,0,0,0,0,0,0,0,0,0,0
0,0,0,0,0,0,0,0,0,0,0,0,0,0,0,0,0,0,0,0,0,0,0,0,0
0,0,0,0,0,0,0,0,0,0,0,0,0,0,0,0,0,0,0,0,0,0,0,0,0
0,0,0,0,0,0,0,0,0,0,0,0,0,0,0,0,0,0,0,0,0,0,0,0,0

#Stages
#Stage Type 0,Map,Mode,Goal,Points,Bonus List(Max 10),Name,End World, then mode settings (see sample tour file for details)
#Stage Type 1,Bonus House Name,Sequential/Random Order,Display Text,Powerup List(Max 5)
12
0,G-Guy-'s Polar Base,1,10,1,0,Polar Base,0,0,0
0,Ice Shelf,16,12,1,0,Ice Shelf,0,2,1,0,30,1,1
0,Im freezing,2,70,1,0,Freezie Path,0,0,0,0
0,Phendrana Cave,9,99,1,0,Phendrana Cave,0,1
0,Ice Fortress,15,25,2,1w14|1w12|2w13|2w11|3w10|4w9,Ice Fortress,0,3,180,0,1,10,10,3,5,0,0,0,0,0,0,0,10,0,1,0,3,1,0
0,Aisland,8,155,1,0,Arctic Isle,0,1,0
0,Melting Artic_,11,50,1,0,Melting Arctic,0,1,150,1,1,1
0,Mt Bananavision!,4,10,1,0,Mount Banana,0,1,3
0,FrozenSomething,5,35,1,0,Something Frozen,0,45,10,1,0,0,0,0,5,0,0
0,The Arctic,0,15,3,0,The Arctic,1,0
1,Toad's House,1,||Pick an item to help you on your way!||,p6,p11,p12
1,Ice House,1,||*frozen*||,p0,p10,p9,p16,p0

#Warps
#location 1 x, y, location 2 x, y
0

#Vehicles
#Sprite,Stage Type, Start Column, Start Row, Min Moves, Max Moves, Sprite Paces, Sprite Direction, Boundary
0

#Initial Items
w1,w4,w10,w10,w10,w13,p6,p7,p7
